
Maze 1
#######
#>   E#
#######

Maze 2
#####E#
#<    #
#######

Maze 3
##########
#>      E#
##########

Maze 4
#####E#
##### #
#>    #
##### #
#######

Maze 5
#####E#
##### #
##### #
##### #
##### #
#>    #
##### #
#######

Maze 6
#########
#E ######
##      #
##### # #
#>    ###
##### ###
##### ###
##### ###
##### ###
##### ###
##### ###
#########

Maze 7
#########
#E ######
##      #
## ## # #
##### # #
#>    ###
##### ###
##### ###
##### ###
##### ###
##### ###
##### ###
#########